222222222222222222222222
211111133011111113111302
210111311131111031111312
211111111111111113331332
211222222222222222222222
210011111300001111111332
211111111113311331133112
211111111122222222222222
233333111111111111111112
233331111111111331111112
211111111133000111111302
233311111111111111111132
211111100000000011133332
211111330111222222222222
211111111330011111111112
203311111113111131111132
231111113001111133331112
211111131111111111113112
211111133011111113111302
222222222222222222222222
222222222222222222222222
000000000000000000000000
000000000000000000000000
000000000000000000000000
