222222222222222222222222
211111100010000000000302
210100000000111003000312
211000333030000033330332
222222222222222222220112
210011411300000000000332
211111111113311331133112
211111111122222222222222
233333111111111111111112
233331000111111331111112
211111100133000111111302
233311000111111111111132
211111100000600011133332
211111330111133333311112
211111111330011111111112
203311111113111131111132
231111113001111133331112
211111131111111111113112
211111133011111113511302
222222222222222222222222
222222222222222222222222
000000000000000000000000
000000000000000000000000
000000000000000000000000
