222222222222222222222222
211111133011111113111302
210111311131111031111312
200011111111111113331332
201222222222222222222222
200011111300001111111332
200000001113311331133112
211111101122222222222222
233333101111111111111112
233331101111111331111112
211111101133000111111302
233310001111111111111132
211110100000000011133332
211110330111222222222222
211110111000011111111112
203310000003111131111132
231111113301111133331112
211111131130001111113112
211111133011111113111302
222222222222222222222222
222222222222222222222222
000000000000000000000000
000000000000000000000000
000000000000000000000000
