7 6
19 19
3 2
50
222222222222222222222222
211111030111111000000022
211011311101111001100012
211000300030000333330332
222222222222222222223112
210011011000000000003332
211111000303311331133112
211111111122222222222222
233333111111000111111112
233331000111010331111112
211111000133000111111302
233311000111101111111132
211111100000060011133332
211111333111133333311112
211111111330011111111112
203311111113111131111132
231111113001111133331112
211111131111111111113112
211111133011111113511302
222222222222222222222222
222222222222222222222222
000000000000000000000000
000000000000000000000000
000000000000000000000000
