222222222222222222222222
211111133011111110111302
210111011101111003000312
211000300030000033330332
222222222222222222220112
210011001000000000000332
211111001003311331133112
211111000322222222222222
233333011111111111111112
233331000111111331111112
211111006133000111111302
233311000111111111111132
211100000000000011133332
211101000111133333311112
211101030030011111111112
203300310010111100000102
231111113303000003330002
211111131111111031113102
211111133011111033511332
222222222222222222222222
222222222222222222222222
000000000000000000000000
000000000000000000000000
000000000000000000000000
