4 3
19 19
0 39
59
222222222222222222222222
211111111111111111111102
211011111111111111111112
211111111111111111111112
214444444111144444444412
214111111111111111114112
214111111111111111141112
214111111111111111411112
214444411111111114111112
214111111111111141111112
214111111111111411111112
214111111111114111111112
214444444111144444444412
211111111111111111111112
211111111111111111111112
211111111111111111111112
211111111111111111111112
211111111111111111111112
211111111111111111111112
222222222222222222222222
222222222222222222222222
000000000000000000000000
000000000000000000000000
000000000000000000000000
