222222222222222222222222
211311011011311311000002
211100330003113110000002
231131130131101100000032
211311310311000000003312
213113110110033100333112
231111130100331003331112
211311310003310033311312
210113110303100033113142
231131133131000331131132
211311311330003311311312
213111113110033113111112
231131131100331101131132
211311111003311331311312
213113110033113113113112
231131100331131101131132
211311003111311331011312
210110033113113113313112
233000331131111111111112
222222222222222222222222
222222222222222222222222
000000000000000000000000
000000000000000000000000
000000000000000000000000
