4 3
19 19
0 2
52
222222222222222222222222
211111330111111131113022
211111311131111031111312
211111111111111113331332
222222222222222222221112
210011411304401111111332
211111111113311331133112
211111111122222222222222
233333111111111111111112
233331000111111331111112
211111106133000111111302
233311000111111111111132
211111100000000011133332
211111330111133333311112
211111111330011111111112
203311111113111131111132
231111113001111133331112
211111131111111111113112
211111133011111113111302
222222222222222222222222
222222222222222222222222
000000000000000000000000
000000000000000000000000
000000000000000000000000
