4 3
19 19
0 2
60
222222222222222222222222
241111111111111111111142
211111111111111111111112
211111111111111111111112
211111111111111111111112
211111111111111111111112
211111111111111111111112
211111111111111111111112
211111111111111111111112
211111111111006111111112
211111111111040111111112
211111111111600111111112
211111111111111111111112
211111111111111111111112
211111111111111111111112
211111111111111111111112
211111111111111111111112
211111111111111111111112
241111111111111111111142
222222222222222222222222

