222222222222222222222222
211111133011111113111302
210111311131111031111312
211111111111111113331332
222222222222222222221112
210011411304401111111332
211111111113311331133112
211111111122222222222222
233333111111111111111112
233331000111111331111112
211111160133000111111302
233311000111111111111132
211111130000000011133332
211111300111133333311112
211111111333011111111112
233311111110111131111132
201111113001111133331112
211111131111111111113112
211111133011111113111302
222222222222222222222222

