222222222222222222222222
211111111111111111111302
210222222222222222222202
220222222222222222220002
211222222222222222222112
211222222222222222222112
211222222222222222222112
211222222222222222222112
211222222222222222222112
211222222222222222222112
211222222222222222222112
211222222222222222222112
211222222222222222222112
211222222222222222222112
211222222222222222222112
211222222222222222222112
211222222222222222222112
211222222222222222222112
211111111111111111111112
222222222222222222222222

