4 3
19 19
0 2
60
222222222222222222222222
211111111111111111111112
211111111111111111111112
211111111111111111111112
211111111111111111111112
211111111111111111111112
211111111111111111111112
211111111111111111111112
211111111144441111111112
211111111144441111111112
211111111144441111111112
211111111144441111111112
211111111111111111111112
211111111111111111111112
211111111111111111111112
211111111111111111111112
211111111111111111111112
211111111111111111111112
211111111111111111111112
222222222222222222222222

