222222222222222222222222
211111221111111311111112
210111311131111031111312
211111111111111111111312
211111111111111111311112
211111111111111111111112
211111113111111111111112
211111111111111111111112
211111111111111111111112
211111111111111131111112
211111111111111111111112
211111111111111111111112
211111111111111111111112
211111111333333331111112
211111111111111111111112
211111111111111111111112
211113331111111111111112
211111111111111111111112
211111111111111111111002
222222222222222222222222

