222222222222222222222222
222222222222222222222222
211111111111111111111142
222222222222222222222212
211111111111111111111112
212222222222222222222222
211111111111111111111112
222222222222222222222212
214111111111111111111112
212222222222222222222222
211111111111111111111112
222222222222222222222212
211111111111111111111142
212222222222222222222222
211111111111111111111112
222222222222222222222212
211111111111111111111112
242222222222222222222222
200000000000000000002222
222222222222222222222222

