4 3
19 19
0 2
60
222222222222222222222222
211111133444431113111302
210111311434441031111312
211111111433311113331332
211222222233322222222222
210011111333301111111332
211111111110311331133112
211111111120322222222222
233333111110111111111112
233331111110111331111112
211111111130000111111302
233311111110111111111132
211111130000000011133332
211111300110022222222222
211111111000011111111112
233311111000001131111132
201111113000001133331112
211111131000001111113112
211111133011111113111302
222222222222222222222222

