4 3
19 19
0 2
60
222222222222222222222222
211111133011111112111142
210111311131111032111112
211111111111111112006002
222222222111111112000002
210011111300001111111112
211111111113311332222222
211111111111111111111112
233333111111111111111112
233331000111111331111112
241111111133000111111302
233311000111111111111132
211111130111113311133332
211111300111133333311112
211111111333011111111112
233311111110111131111132
201111113001111133331112
211111131111111141113112
241111330111111131113012
222222222222222222222222

