222222222222222222222222
211111111111111111000042
211111111111111111006012
211111111111111111000012
211111111111111112222222
210310310113031013011032
211110331031103130101112
211111301111030131133112
231313010131331031331132
210133103131013010141012
210133103130103103133012
213313131311131331111112
211111331311111111303112
231113131131311111313112
211111111111122222111112
211113311111300042111112
213333111111122222111112
233111111111111111111112
241111111111111111111112
222222222222222222222222

