222222222222222222222222
211311311311311311111342
211111111113113111111112
231131131131111131111132
211311311311111111311312
213111111113113113113112
231111130131131131131112
211311311314311311111312
210113113113113111113142
231131130131131111131132
211311111311311311311312
213111113113113113111112
231131131131111131131132
211311111311311301311312
213113113113113113113112
231131131131111131131132
211311111111111101311312
213111113113113113013112
234101131131111111111112
222222222222222222222222

