222222222222222222222222
233333333333333333333332
211111111111111111111142
233333333333333333333312
211111111111111111111112
213333333333333333333332
211111111111111111111112
233333333333333333333312
214111111111111111111112
213333333333333333333332
211111111111111111111112
233333333333333333333312
211111111111111111111142
213333333333333333333332
211111111111111111111112
233333333333333333333312
211111111111111111111112
242222222222222222222222
200000000000000000002222
222222222222222222222222

