222222222222222222222222
211111111111111111111142
211111111111111111111112
211111111111111111111112
211111111111111111111112
211111111111111111111112
211111111111111111111112
211111111111111111111112
211111111111111111111112
211111111110061111111112
211111111110401111111112
211111111116001111111112
211111111111111111111112
211111111111111111111112
211111111111111111111112
211111111111111111111112
211111111111111111111112
211111111111111111111112
241111111111111111111142
222222222222222222222222