4 3
19 19
0 2
60
222222222222222222222222
211311311311311311311342
211111111113113113111112
231131131131131131131132
211311311311311111311312
213113111113113113113112
231111130131131131131112
211311311314311311311312
210113113113113113113142
231131130131131131131132
211311311311311311311312
213111113113113113111112
231131131131131131131132
211311111311311301311312
213113113113113113113112
231131131131131131131132
211311311111311301311312
213111113113113113013112
234101131131111111111112
222222222222222222222222

